NO ./assets/sprites/wall/wall-2.png
EA ./assets/sprites/wall/wall-12.png
SO ./assets/sprites/wall/wall-6.png
WE ./assets/sprites/wall/wall-14.png

F 65,65,65
C 121,146,164

    1111111111111111111111111
    1000000000110000000000001
1111110000101000000000000111111111
1000000000000000011100001111111111
111111111011000001 100000000000011
100000000010000001110000100011111
111100011110110111000000100011
1111101111101110111010100000001
1100000011010101100000000000011
1000E0000000000000000000000111
10000000000000001101010000001
11000001110101011111011010001
11110111 1110101 101111010001
11111111 1111111 111111111111
1111
11
1
